1111211331
1   3    2
2 1 24 3 2
3 2    2 2
1   1  1 3
11 23 12 3
1     1  1
3 1 1 2321
1 2 3    1
1111333112