1112113311
0    3   2
3 1    321
2 5  2   2
1123 12 23
1        1
12 3 12 43
3  2 3   1
1  3 1 3 1
1111333161