1112113311
1        2
1        2
2  5     2
3        3
1123  2  3
1       31
3 1    321
1 2  1   1
1111333111