1112113311
1        1
11134111 1
1        1
1 11123121
1        1
112 4 12 1
1 3 3  5 1
1   2 45 2
1211111161
